2 1 2 3 2 4 2 5 2 6 3 1 3 2 3 3 3 4 3 5 3 6 4 1 4 2 4 3 4 4 4 5 4 6 5 1 5 2 5 3 5 4 5 5 5 6 6 1 6 2 6 3 6 4 6 5 6 6 7 2 7 3 7 4 7 5 7 6 100 100
1 11 1 12 1 13 1 14 2 11 2 12 2 13 2 14 3 9 3 10 3 11 3 12 3 13 3 14 3 15 3 16 4 9 4 10 4 11 4 12 4 13 4 14 4 15 4 16 5 9 5 10 5 11 5 12 5 13 5 14 5 15 5 16 6 9 6 10 6 11 6 12 6 13 6 14 6 15 6 16 7 9 7 10 7 11 7 12 7 13 7 14 7 15 7 16 8 9 8 10 8 11 8 12 8 13 8 14 8 15 8 16 100 100
2 19 2 20 2 21 2 22 2 23 2 24 3 19 3 20 3 21 3 22 3 23 3 24 4 19 4 20 4 21 4 22 4 23 4 24 5 19 5 20 5 21 5 22 5 23 5 24 6 20 6 21 6 22 6 23 100 100
10 1 10 2 10 3 10 4 10 5 11 1 11 2 11 3 11 4 11 5 11 6 11 7 11 8 12 1 12 2 12 3 12 4 12 5 12 6 12 7 12 8 13 1 13 2 13 3 13 4 13 5 13 6 13 7 13 8 14 1 14 2 14 3 14 4 14 5 14 6 14 7 14 8 15 1 15 2 15 3 15 4 15 5 15 6 15 7 15 8 16 1 16 2 16 3 16 4 16 5 16 6 16 7 16 8 100 100
9 19 9 20 9 21 9 22 9 23 9 24 10 19 10 20 10 21 10 22 10 23 10 24 11 19 11 20 11 21 11 22 11 23 11 24 12 19 12 20 12 21 12 22 12 23 12 24 13 19 13 20 13 21 13 22 13 23 13 24 100 100
15 19 15 20 15 21 15 22 15 23 16 18 16 19 16 20 16 21 16 22 16 23 16 24 17 18 17 19 17 20 17 21 17 22 17 23 17 24 18 18 18 19 18 20 18 21 18 22 18 23 18 24 19 19 19 20 19 21 19 22 19 23 100 100
20 1 20 2 20 3 20 4 20 5 20 6 20 7 21 1 21 2 21 3 21 4 21 5 21 6 21 7 22 1 22 2 22 3 22 4 22 5 22 6 22 7 23 1 23 2 23 3 23 4 23 5 23 6 23 7 24 1 24 2 24 3 24 4 24 5 24 6 24 7 25 1 25 2 25 3 25 4 25 5 25 6 100 100
19 10 19 11 19 12 19 13 19 14 19 15 20 10 20 11 20 12 20 13 20 14 20 15 21 10 21 11 21 12 21 13 21 14 21 15 22 10 22 11 22 12 22 13 22 14 22 15 23 10 23 11 23 12 23 13 23 14 23 15 24 10 24 11 24 12 24 13 24 14 24 15 25 10 25 11 25 12 25 13 25 14 25 15 100 100
22 18 22 19 22 20 22 21 22 22 22 23 22 24 23 18 23 19 23 20 23 21 23 22 23 23 23 24 24 18 24 19 24 20 24 21 24 22 24 23 24 24 25 19 25 20 25 21 25 22 25 23 25 24 100 100